10 10
1111111111
1v00020001
1000020101
1000000001
1222001001
1010011201
1010000001
1013030301
1000000001
1111111111
